#Backup ID,Backup Online Processtime(s),Online Load Times,Online Delta num,Online Size,Offline Size,Offline Delta times,Offline Decompress times,Offline Delete times,Logic chunk num,Unique chunk num,FpIndex size,SfIndex size,Localmap size,Coldmap size,Deltamap size,total logical size,offline_time,online_dedupReduce,online_lz4Reduce,online_deltaReduce,offlineDelta_diff,offlineDelta_sum,offlineReDelta_sum,offlineRelz4_sum,_sum_Delta_size,_sum_Lz4_size
0,14.3652,0,0,838586441,380216392,109569,0,209,349658,181563,14525040,13181376,7012928,877597,3825728,2869463040,347.409,1282881380,747995219,0,-458370049,458370049,0,520783812,62413763,317802629
1,8.63862,0,0,616529926,434663899,185869,41104,497,700527,225166,18013280,14672640,9265536,1489437,5157376,5748879360,154.152,3743793558,930185827,0,-640236076,181866027,22838560,718328128,78092052,356571847
2,8.55722,0,0,659166533,473962386,288107,106334,804,1048641,266111,21288880,15328448,11634112,2308876,6477824,8606402560,190.836,6205325664,1101674287,0,-825440223,185204147,58191148,926366506,100926283,373036103
3,8.89304,0,0,712445712,546789151,405044,189539,1177,1400928,309641,24771280,17074112,13792960,3246237,7605376,11506227200,195.821,8682684684,1285656581,0,-991096784,165656561,108169737,1115987667,124890883,421898268
4,8.53619,0,0,771231741,582196514,552950,300369,1533,1749773,350273,28021840,17651584,16165952,4431257,8991328,14379182080,227.638,11157304447,1459549108,0,-1180132011,189035227,177624853,1325097808,144965797,437230717
5,8.63408,0,0,809670642,613272579,729848,439153,1936,2102412,391624,31329920,18180288,18605568,5848456,10271904,17284945920,253.405,13658822550,1636320717,0,-1376530074,196398063,263628505,1539144613,162614539,450658040
6,8.68563,0,0,846674920,637919450,937316,607356,2395,2454706,434179,34734320,18723968,21118592,7510479,11573888,20191088640,281.249,16149298010,1818585636,0,-1585285544,208755470,363638802,1758945556,173660012,464259438
7,8.68164,0,0,862092380,699132635,1161454,796418,2952,2812109,475940,38075200,19924800,23363456,9306360,12747008,23129180160,281.681,18693777114,1988025122,0,-1748245289,162959745,464385926,1951247002,203001713,496130922
8,8.76548,0,0,916429592,737659905,1409868,1008201,3512,3167314,516183,41294640,20520768,25707968,11296472,14031872,26049710080,304.637,21233737782,2151297417,0,-1927014976,178769687,588450001,2152497280,225482304,512177601
9,8.66731,0,0,955920044,768434129,1684316,1245163,4135,3522400,556670,44533600,20980928,28107136,13495163,15296576,28969748480,327.27,23771424370,2315389090,0,-2114500891,187485915,727974305,2357684424,243183533,525250596
10,8.41745,0,0,978876874,792883101,1984722,1509328,4785,3874982,595347,47627760,21368768,30426560,15901645,16503872,31867842560,356.208,26302237172,2472227623,0,-2300494664,185993773,882075537,2557368384,256873720,536009381
11,8.51524,0,0,1005726906,824040080,2308448,1796595,5526,4227381,634533,50762640,21760128,32760256,18495142,17718368,34764001280,378.076,28826733539,2631046171,0,-2482181490,181686826,1042312266,2757888655,275707165,548332915
12,8.78842,0,0,1050229447,845080373,2657919,2107280,6379,4585507,676861,54148880,22352128,35242624,21295175,19006560,37705349120,399.067,31373031151,2799907032,0,-2687330564,205149074,1219461394,2968926745,281596181,563484192
13,8.73672,0,0,1062915927,878287106,3029399,2441193,7270,4940662,717180,57374400,22801600,37646976,24271462,20250432,40626268160,408.149,33912308764,2963712905,0,-2871959385,184628821,1393108762,3175096225,303136840,575150266
14,8.61882,0,0,1089424896,907023180,3424761,2799902,8190,5298219,756126,60490080,23166976,39992896,27438958,21466848,43568435200,427.869,36485681911,3121369008,0,-3054361101,182401716,1583399681,3376359566,321998465,585024715
15,8.5374,0,0,1114819389,924243816,3841159,3179859,9139,5655036,794396,63551680,23436288,42325120,30774887,22672960,46505267200,435.575,39059823559,3276263151,0,-3244936674,190575573,1785746597,3576253443,331316769,592927047
16,8.70578,0,0,1139950897,954891873,4262593,3563902,10337,6017260,834554,66764320,23701824,44718144,34152349,23926656,49483950080,451.667,41660473465,3438589044,0,-3429995698,185059024,1989651312,3779938389,349942691,604949182
17,9.05998,0,0,1170660352,979591586,4719332,3982879,11357,6381829,874758,69980640,24077760,47135040,37811345,25182304,52483553280,478.985,44282121140,3600776090,0,-3621064464,191068766,2209836475,3985105781,364041317,615550269
18,9.11126,0,0,1191612118,1002039531,5206778,4433141,12499,6746630,914145,73131600,24461056,49514944,41716623,26412288,55485675520,491.027,46913334366,3759664572,0,-3810637051,189572587,2439411167,4187691502,377054451,624985080
19,8.78236,0,0,1216993447,1028530780,5712451,4901282,13621,7108426,954067,76325360,24757184,51916992,45767617,27653344,58467983360,500.838,49519009373,3921343489,0,-3999099718,188462667,2674943037,4392196035,393096317,635434463
20,8.60794,0,0,1240131402,1051936125,6246074,5397999,14891,7464498,993174,79453920,25114368,54278976,50042951,28873728,61400565760,493.358,52081521486,4079813154,0,-4187294995,188195277,2924320702,4594626640,407331645,644604480
21,8.43142,0,0,1264288775,1083938989,6778326,5893551,16187,7815621,1032218,82577440,25371840,56627840,54307447,30089504,64291246080,499.845,54600764108,4238898202,0,-4367644781,180349786,3177661184,4796453734,428808953,655130036
22,8.34428,0,0,1294148515,1099804075,7357509,6436357,17492,8163270,1070694,85655520,25800064,58955968,58947436,31288800,67153766400,523.432,57096412962,4395560142,0,-4561989221,194344440,3451912809,4997346648,435357427,664446648
23,8.37665,0,0,1309716602,1130542247,7954338,6996834,18780,8509462,1109121,88729680,26138560,61282880,63728492,32482496,70005688320,577.211,59581930908,4552051589,0,-4741163576,179174355,3725865391,5198905583,457742007,672800240
24,8.82233,0,0,1338367559,1167679621,8579520,7585820,19998,8857126,1147034,91762720,26412352,63599424,68736030,33672640,72872611840,618.597,62086673787,4706406918,0,-4911851514,170687938,4019028855,5399358959,487507445,680172176
25,8.2256,0,0,1373997130,1185876844,9219377,8189501,21286,9205823,1184724,94777920,26633984,65914688,73861326,34859008,75747768320,588.473,64602341301,4859578375,0,-5099971800,188120286,4321252109,5599450719,499478919,686397925
26,8.27423,0,0,1395889341,1200911296,9890288,8823949,22676,9553238,1223126,97850080,26923904,68248448,79235564,36054976,78613667840,606.456,67101701082,5016105617,0,-5294949845,194978045,4632790008,5801074620,506124775,694786521
27,8.25043,0,0,1407879401,1233870135,10578840,9476439,24061,9900471,1260887,100870960,27197888,70556544,84750897,37238016,81478348800,614.554,69605579873,5169939681,0,-5468959111,174009266,4941780821,6000668229,531709118,702161017
28,8.23933,0,0,1443154907,1246768409,11296625,10157728,25605,10248239,1299161,103932880,27467328,72892352,90500889,38435680,84350238720,639.595,72112292483,5325832219,0,-5665345609,196386498,5275460692,6202451318,537105709,709662700
29,8.2826,0,0,1454671158,1273543728,12035858,10860552,27099,10596588,1337206,106976480,27715456,75222528,96422223,39627936,87226378240,646.939,74625781646,5480579827,0,-5846473039,181127430,5607274740,6403681920,557208881,716334847
30,8.45881,0,0,1483941916,1279992434,12793036,11581032,28718,10946481,1375853,110068240,28006400,77571520,102487742,40830272,90117150720,669.117,77149095265,5637640500,0,-6050422521,203949482,5955064060,6606100491,555677970,724314464
31,8.22498,0,0,1485334834,1310245960,13573091,12325200,30229,11291923,1413211,113056880,28250752,79868352,108735737,42004832,92970352640,671.585,79644796590,5789798695,0,-6225511395,175088874,6296255462,6805002862,579491467,730754493
32,8.29102,0,0,1514093163,1319403977,14373770,13090294,31698,11633491,1450134,116010720,28443456,82145792,115148514,43167680,95788369920,696.543,82108474883,5940290479,0,-6420200581,194689186,6652573616,7002945760,582745179,736658798
33,8.38982,0,0,1547583942,1373373119,15178460,13855803,33690,11980449,1491772,119341760,28828672,84653376,121595994,44458048,98655385600,725.771,84579292563,6108308514,0,-6594411404,174210823,7006311786,7219982914,625571510,747801609
34,8.49225,0,0,1597118798,1394696149,15985594,14624476,35611,12328874,1532659,122612720,29206080,87115008,128062671,45728832,101536942080,704.309,87071907152,6273504726,0,-6796834053,202422649,7386961308,7433027798,636193745,758502404
35,8.43096,0,0,1616242749,1434073889,16750833,15351983,37839,12678852,1573224,125857920,29475776,89530048,134195715,46989312,104431165440,665.92,89580316150,6437772488,0,-6979002913,182168860,7759192671,7641561092,662558179,771515710
36,8.52849,0,0,1652488888,1452226541,17543269,16106978,39620,13027926,1613137,129050960,29833664,91926336,140544108,48239840,107317770240,683.615,92086635126,6599643313,0,-7179265260,200262347,8143992450,7848523974,669258714,782967827
37,8.37443,0,0,1669086624,1476891353,18372304,16898833,41518,13379379,1652971,132237680,30291200,94305856,147185878,49476672,110227466240,701.029,94618329844,6760784512,0,-7371460531,192195271,8536043039,8053316675,681856144,795035209
38,8.41113,0,0,1688430916,1502471999,19228220,17718118,43289,13728163,1691563,135325040,30590336,96650240,154042061,50690144,113113917440,713.888,97136722306,6917303687,0,-7557419448,185958917,8936026120,8255946338,698526890,803945109
39,8.3866,0,0,1713833152,1545097138,20107287,18560862,45097,14076885,1730035,138402800,30935808,98974976,161083637,51893056,116000757760,742.398,99655474725,7074030435,0,-7726155462,168736014,9344446637,8457862869,731707407,813389731
40,8.32325,0,0,1758922505,1563960373,21007811,19424319,47041,14428208,1769259,141540720,31268096,101347264,168297541,53120832,118909593600,752,102191448230,7233067403,0,-7921117594,194962132,9777355913,8662261950,741144356,822816017
41,8.4164,0,0,1775568615,1582181278,21908918,20288890,48942,14776888,1807925,144634000,31593600,103685632,175515894,54330560,121795717120,757.781,104708910404,7390120507,0,-8114504931,193387337,10208197965,8864405194,749900263,832281015
42,8.29267,0,0,1795084459,1626823665,22823799,21166871,50927,15125521,1846954,147756320,31927936,106047232,182844867,55552032,124680949760,787.301,107222820566,7548539804,0,-8282765725,168260794,10640637113,9067764430,784998705,841824960
43,8.40921,0,0,1837248023,1649958986,23721079,22027710,52818,15474430,1885464,150837120,32175936,108379648,190032562,56755392,127569377280,761.352,109744743659,7704619873,0,-8470054762,187289037,11081780308,9268768852,798714090,851244896
44,8.32304,0,0,1858556203,1684559639,24657161,22927698,54876,15821608,1923538,153883040,32508288,110689856,197531508,57947712,130441646080,782.848,112253753981,7859281134,0,-8644051326,173996564,11540706720,9468441487,824390161,860169478
45,8.47891,0,0,1892649282,1673995779,25590357,23824705,56812,16170670,1961503,156920240,32761472,113006016,205006756,59141184,133332664320,759.165,114782372714,8013590998,0,-8862704829,218653503,12010327848,9668498161,805793332,868202447
46,8.46531,0,0,1882128765,1715519367,26551326,24749310,58884,16521828,1999608,159968640,33027328,115333504,212704868,60338688,136244039680,791.723,117331209415,8167996671,0,-9029314227,166609398,12455583119,9869254250,839940023,875579344
47,8.49675,0,0,1924978862,1749282224,27514874,25676569,60974,16873063,2038050,163044000,33359872,117656128,220423702,61536096,139155404800,811.597,119877339502,8323772209,0,-9205010865,175696638,12925911413,10069301605,864290740,884991484
48,8.45993,0,0,1960559739,1773741442,28494213,26619103,63135,17225102,2076957,166156560,33680128,120011776,228269219,62750944,142071173120,817.526,122424520062,8481082454,0,-9391829162,186818297,13412779155,10271738306,879909144,893832298
49,8.42239,0,0,1983459228,1789094834,29492932,27581337,65363,17574419,2115318,169225440,33958208,122346944,236270111,63953824,144962355200,819.523,124950133411,8636933399,0,-9586193556,194364394,13906748193,10473049975,886856419,902238415
50,8.37094,0,0,2001327094,1818493973,30486955,28538434,67452,17926301,2154337,172346960,34274112,124710208,244232724,65173728,147876433920,834.913,127493928362,8794984908,0,-9769026677,182833121,14399285721,10676117530,907090853,911403120
51,8.38779,0,0,2026226245,1835512449,31472853,29488215,69366,18271894,2192243,175379440,34519360,127021696,252129470,66364928,150738626560,836.26,129993697265,8949676373,0,-9959740473,190713796,14892830353,10875834094,916093621,919418828
52,8.25936,0,0,2041638819,1885988406,32456613,30436053,71241,18617702,2229865,178389200,34780864,129321280,260008925,67545760,153603604480,842.077,132499445958,9102779230,0,-10115390886,155650413,15390311597,11074264306,958873420,927114986
53,8.38387,0,0,2090273961,1901418245,33479206,31423077,73135,18965640,2267172,181373760,35035456,131597696,268199131,68717536,156488765440,850.213,135028886301,9254214292,0,-10304246602,188855716,15924655992,11270558066,966311464,935106781
54,8.36066,0,0,2109579456,1926114827,34524986,32432386,74977,19314713,2305354,184428320,35290880,133931840,276574581,69911040,159383644160,885.047,137560492431,9409325671,0,-10487711231,183464629,16459770872,11471342543,983631312,942483515
55,8.48734,0,0,2136943360,1938425156,35586065,33456763,76883,19663418,2344057,187524560,35590592,136280832,285072735,71114016,162274867200,904.489,140083486020,9566726589,0,-10686229435,198518204,16999985244,11673506757,987277322,951147834
56,8.61888,0,0,2152276086,1965171447,36667492,34500829,78875,20013675,2383448,190675840,35913920,138672128,293734111,72338752,165181665280,912.886,142616050994,9727108765,0,-10873334074,187104639,17532330920,11878700503,1005366429,959805018
57,8.31627,0,0,2171892122,1972857990,37761223,35558336,80747,20362245,2421236,193698880,36123648,140990592,302493311,73526272,168073625600,915.288,145147365935,9881033469,0,-11072368206,199034132,18073610295,12078589251,1006221045,966636945
58,8.46985,0,0,2184907385,1988621263,38889852,36649943,82794,20711122,2460140,196811200,36428672,143360192,311532578,74739936,170970521600,955.963,147673200145,10040045864,0,-11268654328,196286122,18618717827,12282563421,1013909093,974712170
59,8.40841,0,0,2193276565,2041802898,40009289,37733561,84917,21060301,2497568,199805440,36614016,145652608,320498689,75920960,173870110720,962.833,150216132275,10192047552,0,-11420127995,151473667,19157975134,12480088073,1059960078,981842820
60,8.37959,0,0,2247303124,2059929508,41168808,38856902,86805,21409582,2535174,202813920,36835456,147968128,329784281,77104288,176770754560,915.779,152758363219,10344960222,0,-11607501611,187373616,19737707576,12679344638,1071843027,988086481
61,8.36613,0,0,2268425315,2073089804,42326643,39978152,88788,21758839,2573456,205876480,37024768,150309632,339056876,78301600,179671726080,915.245,155295015165,10500783989,0,-11802837122,195335511,20314550404,12880743472,1077906350,995183454
62,8.36877,0,0,2284517901,2105951693,43484219,41098734,90928,22110179,2612534,209002720,37371328,152677760,348328176,79517536,182588170240,911.998,157841922396,10658892821,0,-11981403330,178566208,20896316605,13083331983,1101928653,1004023040
63,8.39766,0,0,2316214984,2133474804,44699629,42277354,92906,22458283,2651107,212088560,37640704,155032448,358061346,80722080,185476454400,936.43,160362931447,10815904639,0,-12164143510,182740180,21496907733,13285925280,1121781770,1011693034
64,8.44173,0,0,2342897836,2151844134,45933879,43474986,94952,22807536,2689545,215163600,37935552,157376128,367945560,81922272,188373995520,970.64,162894770613,10972183561,0,-12355197212,191053702,22107433958,13487421509,1132224297,1019619837
65,8.33912,0,0,2358825379,2155213490,47195986,44700834,96880,23153242,2727239,218179120,38165376,159696832,378052056,83107008,191239946240,965.773,165399930110,11125993539,0,-12558809101,203611889,22725106652,13687984985,1129175884,1026037606
66,8.30219,0,0,2360467687,2174976351,48484798,45953479,98829,23501375,2764639,221171120,38347456,162011648,388372297,84289472,194128947200,975.863,167931235287,11278435125,0,-12744300437,185491336,23343814363,13887804538,1143504101,1031472250
67,8.29718,0,0,2380231977,2196571460,49783079,47215609,100779,23849800,2802055,224164400,38531392,164325440,398768295,85469792,197020743680,994.771,170465260461,11430950805,0,-12927960954,183660517,23960462665,14087567636,1159606682,1036964778
68,8.49525,0,0,2405096444,2223401670,51069925,48465967,102804,24197521,2840113,227209040,38739328,166660736,409073180,86660224,199907051520,1006.26,172987555974,11586438148,0,-13109655728,181694774,24585142502,14289128815,1179473087,1043928583
69,8.42658,0,0,2433010074,2248826097,52394943,49754347,104873,24546857,2878491,230279280,39025344,169005568,419683669,87855936,202809763840,1051.62,175523771205,11743326833,0,-13293839705,184183977,25228285170,14491125273,1197285568,1051540529
70,8.45881,0,0,2457857263,2268857361,53730186,51052859,107089,24897909,2916854,233348320,39268736,171356608,430376693,89057760,205728215040,1058.14,178077127593,11899390479,0,-13482839607,188999902,25879743019,14693178577,1210338970,1058518391
71,8.76939,0,0,2479808926,2286254706,55090816,52376444,109310,25251386,2955664,236453120,39543040,173727744,441272838,90270112,208668569600,1061.28,180648679595,12057241472,0,-13676393827,193554220,26539555912,14896753492,1220359665,1065895041
72,8.43917,0,0,2495506030,2319528532,56471531,53720439,111482,25602695,2993999,239519920,39785984,176077888,452329418,91469440,211589539840,1085.15,183204271894,12213368089,0,-13852371325,175977498,27197770683,15099125533,1246754208,1072774324
73,8.37417,0,0,2525485358,2323800622,57872628,55085296,113588,25952879,3031642,242531360,39983808,178397504,463548724,92653888,214500464640,1077.3,185756106985,12366500972,0,-14054056061,201684736,27881920593,15299207148,1245151087,1078649535
74,8.49719,0,0,2530929895,2357968748,59283676,56459925,115762,26306780,3069665,245573200,40224960,180728320,474847978,93844192,217447301120,1086.54,188341290218,12521024946,0,-14227017208,172961147,28551027602,15499396997,1272379789,1085588959
75,8.58706,0,0,2568149787,2368412302,60651784,57791314,118366,26661969,3108343,248667440,40384320,183078400,485805862,95052672,220407265280,1060.61,190933678843,12678419442,0,-14426754693,199737485,29228534363,15700930419,1274175726,1094236576
76,8.61499,0,0,2578595504,2400946386,62109591,59212139,120531,27016854,3147052,251764160,40683392,185445248,497479143,96263072,223364904960,1089.02,193523691673,12835863090,0,-14604403811,177649118,29915867816,15903569135,1299165324,1101781062
77,8.67731,0,0,2612046307,2405324172,63592293,60657562,122737,27372834,3185939,254875120,40948480,187831232,509351789,97480256,226333276160,1130.48,196122657631,12994168411,0,-14811125946,206722135,30625257730,16107812574,1296686628,1108637544
78,8.71831,0,0,2616684921,2422335752,65116860,62144856,124882,27727488,3224888,257991040,41211904,190216832,521559042,98698816,229288622080,1159.15,198708165687,13152645526,0,-15005475115,194349169,31342171495,16312304476,1306829361,1115506391
79,8.58764,0,0,2632099478,2465989112,66648574,63639654,126938,28083712,3263563,261085040,41490176,192579520,533823034,99906624,232259921920,1210.38,201312519662,13309827665,0,-15171585481,166110366,32053309709,16514812410,1343226929,1122762183
80,8.67854,0,0,2673469678,2471755553,68171589,65126139,129070,28435875,3301590,264127200,41630208,194917568,546017814,101099968,235194050560,1179.89,203884249465,13464745936,0,-15373299606,201714125,32785055790,16716363473,1343063867,1128691686
81,8.72821,0,0,2678548895,2503809739,69735608,66653707,131325,28788926,3339470,267157600,41885632,197250432,558541241,102292384,238136698880,1246.18,206465766125,13619084254,0,-15548038762,174739156,33507338370,16916821538,1368782776,1135026963
82,8.81323,0,0,2717096535,2525319502,71241618,68122685,134225,29143842,3378802,270304160,42091392,199620544,570603821,103512064,241094256640,1193.01,209050729259,13778392084,0,-15739815795,191777033,34238168468,17119468428,1379652633,1145666869
83,8.83603,0,0,2735642431,2563827468,72851734,69695889,136485,29499437,3417432,273394560,42418048,201982976,583496049,104721120,244057620480,1238.99,211646355129,13935807125,0,-15911630758,171814963,34995111374,17322346119,1410715361,1153112107
84,8.61012,0,0,2773901384,2551856019,74463319,71270466,138748,29855034,3456001,276480080,42652800,204351552,596400044,105932416,247020236800,1260.44,214241809468,14092895190,0,-16133676123,222045365,35773432052,17525678611,1392002488,1159853531
85,8.55519,0,0,2761489396,2604988527,76098587,72868880,140909,30207386,3494354,279548320,42903488,206710208,609492985,107135488,249952245760,1254.86,216807712909,14249367332,0,-16290176992,156500869,36520352194,17728812862,1438635870,1166352657
86,8.67559,0,0,2814680207,2605276958,77736546,74470083,143151,30560280,3532733,282618640,43157632,209062720,622607867,108334624,252891033600,1249.99,219380219581,14405956820,0,-16499580241,209403249,37306297125,17931566975,1431986734,1173290224
87,8.65408,0,0,2812475214,2627618435,79422291,76119382,145373,30912241,3570528,285642240,43366656,211395328,636104937,109523008,255821864960,1271.12,221949641224,14560168281,0,-16684437020,184856779,38085577532,18133056662,1448619642,1178998793
88,8.75307,0,0,2835297180,2621252302,81112289,77772722,147662,31267094,3608514,288681120,43576256,213741440,649636366,110720096,258780006400,1261.89,224545183706,14715088494,0,-16898481898,214044878,38868409783,18335061957,1436580059,1184672243
89,8.89707,0,0,2847092576,2697433112,82835006,79456241,150207,31622355,3650337,292026960,44011200,216250176,663430827,111999712,261743943680,1295.97,227110739310,14887629896,0,-17048141362,149659464,39641970673,18550130373,1501989011,1195444101
90,8.69486,0,0,2904139401,2725250091,84573467,81158243,152501,31975457,3688084,295046720,44204544,218583552,677349985,113198176,264688977920,1299.56,229694996288,15041700869,0,-17227030672,178889310,40473497113,18751247446,1524216774,1201033317
91,8.78254,0,0,2935862934,2707421175,86349531,82897211,154771,32331840,3726857,298148560,44463232,220957824,691569847,114409056,267663267840,1313.41,232300965272,15199408962,0,-17455472431,228441759,41322069469,18954867518,1499395087,1208026088
92,8.87855,0,0,2919091715,2740812935,87996981,84507818,158052,32688080,3765813,301265040,44582272,223315840,704765852,115627488,270636738560,1262.92,234903973489,15358200925,0,-17633751211,178278780,42105510315,19157231550,1523480339,1217332596
93,8.75338,0,0,2952487978,2791439788,89785193,86258941,160447,33044759,3804790,304383200,44986432,225689536,719083515,116840032,273613271040,1302.14,237510159608,15516872243,0,-17794799401,161048190,42927730361,19360962744,1566163343,1225276445
94,8.75518,0,0,3002594049,2782306332,91605135,88041612,162861,33401030,3843726,307498080,45261248,228074880,733655121,118060832,276588656640,1340.37,240116081966,15675181224,0,-18015087118,220287717,43797102114,19565134395,1550047277,1232259055
95,8.7353,0,0,2998398335,2804655391,93361486,89760377,165002,33757572,3883649,310691920,45534016,230480384,747716634,119296512,279567728640,1304.98,242716157918,15838085269,0,-18208830062,193742944,44601649422,19771058180,1562228118,1242427273
96,8.65984,0,0,3008484703,2853563486,95177519,91540405,167078,34112191,3920889,313671120,45724160,232784704,762255278,120478272,282529177600,1327.91,245322629490,15989233345,0,-18363751279,154921217,45421645613,19969334272,1605582993,1247980493
97,8.78299,0,0,3062391130,2887265248,97028108,93354160,169488,34468564,3959205,316736400,45973184,235142080,777072040,121680736,285508986880,1385.76,247937658722,16145185749,0,-18538877161,175125882,46283176971,20171873360,1632996199,1254269049
98,8.70231,0,0,3100002813,2904026980,98910969,95199349,172003,34830513,3998557,319884560,46247552,237553152,792147503,122910144,288542586880,1356.15,250598715987,16304990919,0,-18734852994,195975833,47173831067,20377618134,1642765140,1261261840
99,9.018,0,0,3116970130,2904286716,100817517,97068324,174544,35190865,4037891,323031280,46528320,239957824,807412576,124139456,291560990720,1413.28,253244111757,16465055839,0,-18947536408,212683414,48087275139,20583133715,1635597307,1268689409
100,8.87257,0,0,3117925439,2944186997,102740331,98953546,176962,35549681,4077328,326186240,46820352,242363712,822807170,125366560,294563993600,1371.15,255873018742,16625513011,0,-19121274850,173738442,48967529725,20788981060,1667706210,1276480787
101,8.63805,0,0,3154316247,2948805692,104674783,100850872,179563,35905999,4116067,329285360,47075392,244739776,838295775,126578592,297546045440,1379.47,258487172501,16783281842,0,-19326785405,205510555,49863169018,20992665012,1665879607,1282926085
