Backup ID,Backup Online Processtime(s),Online Load Times,Online Delta num,Online Size,Offline Size,Offline Delta times,Offline Decompress times,Offline Delete times,Logic chunk num,Unique chunk num,FpIndex size,SfIndex size,Localmap size,Coldmap size,Deltamap size,total logical size,offline_time,online_dedupReduce,online_lz4Reduce,online_deltaReduce,offlineDelta_diff,offlineDelta_sum,offlineReDelta_sum,offlineRelz4_sum,_sum_Delta_size,_sum_Lz4_size
0,1.49141,0,0,100654960,100523531,55,0,15,24641,24495,1959600,4682368,3520,515,2944,208250880,0.433847,1127989,106467931,0,-131429,131429,0,196644,65215,100458316
1,1.14932,0,0,167725270,130228867,8515,35,55,49838,39626,3170080,5967936,542848,68395,540160,420976640,26.6008,77093471,176026470,0,-37627832,37496403,60768,39038368,1410536,128818331
2,1.15509,0,0,196926383,155732342,23321,5566,112,75769,54678,4374240,7071552,1136832,187128,956864,640409600,41.431,159458006,246397379,0,-78821873,41194041,975569,81715527,2893654,152838688
3,1.15877,0,0,221418110,180563030,43158,16132,187,102154,69374,5549920,8105664,1730432,346199,1346688,864501760,52.2497,248725373,315536404,0,-119676953,40855080,2649272,124447932,4770979,175792051
4,1.1996,0,0,251256595,209786603,67226,30753,282,128934,85204,6816320,9322496,2335296,539218,1740992,1092659200,58.696,332019363,389706289,0,-161146945,41469992,5183525,168146867,6999922,202786681
5,1.25793,0,0,284233921,241335989,95039,48726,400,156457,101934,8154720,10634368,2965824,762304,2158400,1326612480,62.6969,413501574,467730040,0,-204044877,42897932,8742442,213527797,9482920,231853069
6,1.26718,0,0,316637616,271852267,126644,70081,540,184290,118788,9503040,11892480,3622144,1015844,2593632,1563217920,68.0629,496131554,546403873,0,-248830226,44785349,13189731,260884525,12054299,259797968
7,1.31422,0,0,350328560,305145515,161113,94156,702,212510,136407,10912560,13268416,4287616,1292406,3028512,1803356160,70.3341,576072305,628125069,0,-294013271,45183045,18539460,308791959,14778688,290366827
8,1.37575,0,0,388742651,339446536,198915,120627,885,241451,155151,12412080,14678208,5013248,1595737,3516192,2049822720,77.1178,652356600,714710198,0,-343309386,49296115,24495587,361159120,17849734,321596802
9,1.31933,0,0,416125921,365225216,240435,150638,1087,270745,172102,13768160,15711296,5750080,1928907,3998112,2300139520,80.9783,745473835,795230378,0,-394210091,50900705,31432380,414606496,20396405,344828811
10,1.37892,0,0,443582443,393354956,286238,184864,1312,300593,189672,15173760,16844992,6491712,2296456,4463584,2554542080,85.8737,838570276,878179270,0,-444437578,50227487,39205653,467921224,23483646,369871310
11,1.41263,0,0,475844715,425240896,334697,221880,1557,331389,208165,16653200,18183168,7224384,2685329,4924800,2817464320,85.9103,931766067,965415960,0,-495041397,50603819,47946642,520949067,25907670,399333226
12,1.4233,0,0,508630399,459491309,384525,260149,1819,362473,226816,18145280,19529792,7964736,3085239,5401280,3082168320,89.7832,1025548125,1052948399,0,-544180487,49139090,56642543,574588119,30407632,429083677
13,1.54821,0,0,553616844,502816121,436463,300020,2111,394467,248136,19850880,21291712,8737344,3502203,5902720,3355002880,91.3517,1105497193,1151708356,0,-594981210,50800723,66983150,629498923,34517713,468298408
14,1.5806,0,0,598692729,548999751,487294,339362,2431,427730,269719,21577520,23216192,9473152,3910451,6386944,3639654400,88.4195,1193548449,1252432012,0,-644674188,49692978,77675196,682485149,37810961,511188790
15,1.63224,0,0,644787364,590780322,540919,380425,2766,461573,291289,23303120,24930432,10277312,4341110,6929024,3929231360,93.833,1286362675,1353407133,0,-698681230,54007042,88826159,740220898,41539668,549240654
16,1.66161,0,0,689692859,641534022,589137,417445,3099,495907,313484,25078720,27022080,10994368,4728519,7400640,4223057920,85.8781,1377714707,1456969124,0,-746840067,48158837,98950388,792741200,45901133,595632889
17,1.76692,0,0,743230968,706574721,638872,455509,3457,533891,338250,27060000,29509568,11742784,5128181,7899360,4533319680,87.8713,1477945546,1565303099,0,-783496314,36656247,110043564,846841979,63345665,643229056
18,1.94246,0,0,819379027,752906148,696167,499198,3836,573226,363914,29113120,31804224,12613760,5588420,8485760,4869498880,101.424,1580768804,1685854735,0,-849969193,66472879,134033159,906362875,56393682,696512466
19,2.02143,0,0,868328514,805253951,757717,546124,4223,614460,390057,31204560,33995648,13550144,6082755,9115744,5222645760,109.689,1694967826,1809380227,0,-913043756,63074563,148378339,973430121,60386365,744867586
20,1.98898,0,0,920590971,853105016,825384,598313,4632,657190,416136,33290880,36012160,14541312,6626128,9763040,5588357120,120.004,1821298679,1933423714,0,-980529711,67485955,163674493,1044733280,64203569,788901447
21,2.1062,0,0,975943507,906315922,899900,656657,5041,701984,444128,35530240,38262208,15576704,7224301,10427776,5970749440,129.737,1947945757,2066330465,0,-1050157296,69627585,180024593,1118890750,68733454,837582468
22,2.15137,0,0,1030533419,956960975,981132,720680,5492,748244,472329,37786320,40348928,16678720,7876396,11144128,6365849600,136.474,2084043665,2201115220,0,-1123729740,73572444,197622709,1197431847,73702107,883258868
23,2.17398,0,0,1080715670,1001675841,1068884,790254,5959,795533,500237,40018960,42191744,17842880,8580739,11891232,6770524160,143.978,2231071622,2335007128,0,-1202769569,79039829,217028699,1280572105,77802536,923873305
24,2.24416,0,0,1127959256,1047462387,1162839,865632,6436,843831,528928,42314240,44111296,19032768,9334732,12644480,7183421440,150.761,2379879231,2472813384,0,-1283266438,80496869,237295854,1365514031,82247593,965214794
25,2.22315,0,0,1172308050,1092529635,1261810,946070,6959,892453,557325,44586000,45981632,20219584,10129115,13384576,7597076480,158.544,2532953771,2608548221,0,-1363044853,79778415,257831324,1450032220,86987367,1005542268
26,2.36407,0,0,1227981594,1146971273,1365148,1030672,7526,943081,588339,47067120,48318400,21419136,10958638,14132640,8028426240,158.143,2680826906,2756572887,0,-1444055174,81010321,279389614,1535587853,91532679,1055438594
27,2.31199,0,0,1276069090,1191269711,1475067,1120900,8091,994732,617593,49407440,50130240,22680064,11840791,14930976,8468920320,168.141,2850827085,2897968971,0,-1528854553,84799379,301935299,1625051980,96197427,1095072284
28,2.43401,0,0,1328895388,1239756034,1593663,1218566,8780,1047519,648825,51906000,52085952,24020416,12792980,15762496,8918517760,177.985,3012861594,3047906225,0,-1617993907,89139354,325795448,1720380874,102386967,1137369067
29,2.33992,0,0,1370058348,1282165661,1717593,1321992,9397,1100481,678191,54255280,53765184,25333568,13787473,16574752,9369497600,180.271,3191999268,3189446077,0,-1705886594,87892687,351864469,1813947663,108061069,1174104592
30,3.46647,0,0,1497276838,1455309809,1795474,1387646,10237,1161683,730293,58423440,61405568,26116672,14414721,17059072,9891061760,110.625,3259751468,3428146860,0,-1747853623,41967029,368450190,1868311415,120457792,1334852017
31,2.7447,0,0,1606263399,1506316312,1882133,1451416,10743,1224165,764459,61156720,63554688,27582336,15110507,18296960,10425190400,153.419,3476054732,3595018646,0,-1847800710,99947087,391281993,1972233547,124432837,1381883475
32,2.80126,0,0,1658799820,1555196227,1982629,1528123,11257,1287906,799067,63925360,65616000,29105344,15917037,19261056,10969159680,174.514,3698912309,3763646841,0,-1951404303,103603593,415768720,2080522461,129118158,1426078069
33,2.90944,0,0,1708634158,1601093306,2100594,1621093,11809,1352398,833924,66713920,67487744,30705856,16863485,20244512,11518976000,192.433,3926063676,3932873863,0,-2058945155,107540852,442735762,2193538422,134593267,1466500039
34,2.93318,0,0,1758514476,1649589369,2230510,1725789,12397,1418053,869731,69578480,69497472,32320512,17905753,21229504,12079032320,204.438,4153802344,4107770345,0,-2167870262,108925107,471832793,2307979005,140108743,1509480626
35,2.97689,0,0,1812206466,1701142977,2372146,1841585,13036,1485051,906885,72550800,71646464,33974912,19042012,22239040,12650547200,218.544,4381235100,4289235372,0,-2278933751,111063489,502639793,2424778973,145845222,1555297755
36,3.0554,0,0,1862603253,1749021182,2524852,1968135,13689,1552883,943650,75492000,73655936,35649536,20266901,23253472,13229209600,229.1,4618229336,4469443260,0,-2392515822,113582071,535369695,2543288888,150773066,1598248116
37,2.97193,0,0,1910679970,1797709524,2687375,2104284,14385,1620506,980487,78438960,75634176,37339072,21570533,24270080,13805813760,236.968,4852771870,4649846098,0,-2505486268,112970446,568860420,2662902870,157416602,1640292922
38,2.97503,0,0,1959653609,1841967058,2863201,2252816,15066,1688546,1017268,81381440,77426880,39086784,22980514,25324384,14386237440,254.64,5091633912,4829463651,0,-2623172819,117686551,605231715,2786163127,162990308,1678976750
39,3.04099,0,0,2005629321,1891265190,3046546,2409461,15876,1757006,1054333,84346640,79390272,40796416,24451300,26338720,14970695680,253.187,5330626141,5011267399,0,-2737536950,114364131,642728431,2907378723,169841773,1721423417
40,2.35648,0,0,2020766991,1927411786,3221906,2563839,16977,1810412,1083547,86683760,80936576,42140800,25859669,27131872,15425167360,195.69,5513761015,5153102404,0,-2830892155,93355205,688106726,3002478932,171586777,1755825009
41,2.49587,0,0,2060213682,1968595559,3407304,2727767,18080,1864540,1113534,89082720,82530688,43515520,27348352,27950880,15886080000,230.635,5696867449,5298106714,0,-2922510278,91618123,730548816,3100080270,177569992,1791025567
42,2.42353,0,0,2100567833,2005595290,3601952,2900348,19209,1919273,1143338,91467040,83979968,44928064,28911141,28794816,16352163840,240.3,5886502744,5442582985,0,-3017482821,94972543,775234498,3200424323,182941502,1822653788
43,2.43528,0,0,2140349948,2046067500,3804378,3080368,20353,1974837,1173737,93898960,85471680,46363392,30536261,29640096,16824729600,247.14,6077342917,5589553914,0,-3111765269,94282448,820742595,3302361589,190596320,1855471180
44,2.45414,0,0,2180341305,2083321387,4016335,3269664,21500,2031182,1204027,96322160,86894720,47814464,32237620,30493920,17304453120,254.287,6275477097,5736869449,0,-3208785187,97019918,869176810,3405325070,196539883,1886781504
45,2.46346,0,0,2215342484,2115981933,4239678,3469808,22641,2088613,1233728,98698240,88101312,49300288,34030045,31363712,17793658880,264.106,6486965354,5882565855,0,-3308145738,99360551,919523537,3510594919,202449181,1913532752
46,2.57421,0,0,2251868189,2149404574,4475406,3681759,23823,2147190,1264387,101150960,89374144,50823104,35921739,32242688,18292684800,270.45,6699480167,6033190706,0,-3410609353,102463615,972293563,3618379989,207770636,1941633938
47,2.60845,0,0,2283720597,2178952368,4723382,3905380,24993,2206496,1294554,103564320,90440064,52382400,37911373,33140480,18798346240,282.311,6921983768,6182032522,0,-3515377582,104768229,1026530384,3728920878,213543296,1965409072
48,2.50429,0,0,2308577796,2199567068,4984764,4142152,26151,2266715,1323504,105880320,91220096,53958336,40008219,34026400,19312179200,291.305,7161780866,6326442956,0,-3624388310,109010728,1083384911,3840779864,216391554,1983175514
49,2.98979,0,0,2359583041,2250124309,5223288,4353917,27388,2335940,1359838,108787040,93023552,55672064,41922564,35041888,19902177280,271.343,7413083172,6505122757,0,-3733847042,109458732,1130471172,3962116968,228269926,2021854383
50,4.44873,0,0,2521167117,2453488394,5404264,4514569,29063,2419066,1426420,114113600,101868992,56974272,43378723,35833184,20615280640,222.562,7537590402,6822676079,0,-3801525765,67678723,1169455572,4050972239,249446474,2204041920
51,3.91464,0,0,2648346415,2515017648,5590577,4669641,30209,2503193,1471068,117685440,104416320,58974976,44874949,37419104,21337559040,263.074,7844808732,7042878128,0,-3934854532,133328767,1217759250,4191165912,256311380,2258706268
52,4.07353,0,0,2721115284,2586655188,5793864,4840765,31257,2593570,1520912,121672960,107767808,61035392,46506453,38701120,22117294080,281.264,8160797355,7300526909,0,-4069314628,134460096,1268828517,4334328541,265013913,2321641275
53,4.04257,0,0,2790540835,2645421407,6016547,5029641,32321,2687808,1568890,125511200,110454784,63200320,48293205,40031264,22935326720,305.485,8527811966,7547659291,0,-4214434056,145119428,1324280618,4484871219,270437163,2374984244
54,3.91877,0,0,2846235832,2709492467,6243464,5223779,33502,2782874,1615142,129211360,113007616,65299392,50114406,41287424,23760384000,308.073,8921946929,7777767183,0,-4351177421,136743365,1378310298,4631578388,280400967,2429091500
55,4.05082,0,0,2917617247,2769218847,6486952,5432361,34705,2878878,1662942,133035360,115445760,67535168,52068285,42649248,24594739200,329.012,9310442950,8015501582,0,-4499575821,148398400,1437764733,4787220457,287644636,2481574211
56,4.03754,0,0,2973892590,2826545615,6742330,5653171,35843,2975128,1710128,136810240,117827136,69749888,54116975,43974816,25430681600,338.955,9704967003,8252246186,0,-4646922796,147346975,1499018221,4941480726,294557930,2531987685
57,4.01088,0,0,3029883645,2888815671,6991290,5868393,36961,3070965,1757037,140562960,120320256,71910976,56114197,45267552,26264494080,329.95,10099884549,8487803090,0,-4787990770,141067974,1556892511,5092382267,304391497,2584424174
58,3.9766,0,0,3089949076,2946880161,7249250,6092356,38176,3166442,1803100,144248000,122598272,74088704,58183920,46573856,27094425600,335.912,10499173392,8717312362,0,-4931059685,143068915,1617876328,5245033800,313974115,2632906046
59,4.00581,0,0,3151320731,3007883526,7519016,6327841,39478,3262959,1849992,147999360,124980416,76283904,60348526,47878016,27933890560,349.452,10900862913,8950647231,0,-5074496890,143437205,1681353882,5398434876,323937986,2683945540
60,3.09694,0,0,3170949540,3039713358,7837043,6617944,41267,3332759,1886832,150946560,126642304,78072576,62901671,48909312,28529817600,290.056,11152216813,9132154357,0,-5205733072,131236182,1764923638,5524298871,318565799,2721147559
61,4.09418,0,0,3245105716,3106141163,8120351,6866806,42600,3430872,1934164,154733120,129074624,80278656,65174800,50218944,29384591360,318.355,11563081108,9370671464,0,-5344697625,138964553,1825806057,5678285687,333588062,2772553101
62,3.14713,0,0,3274469788,3149216057,8455590,7173107,44467,3504712,1972423,157793840,130808768,82132416,67865991,51301888,30015549440,325.372,11837329259,9559052768,0,-5469951356,125253731,1907428433,5808786126,338834770,2810381287
63,3.16134,0,0,3314575461,3186306201,8805112,7493326,46201,3579605,2009807,160784560,132307456,84009344,70670805,52386528,30656389120,374.258,12127182474,9744679829,0,-5598220616,128269260,1989308252,5940749317,342528701,2843777500
64,3.23575,0,0,3354786497,3227439743,9167084,7825100,47990,3655420,2047926,163834080,133778496,85943488,73575478,53491520,31304744960,382.063,12418216155,9933521692,0,-5725567370,127346754,2070198618,6077226647,351659277,2875780466
65,3.21818,0,0,3395094417,3260958075,9546381,8173734,49722,3732183,2085663,166853040,135081728,87907840,76618474,54602880,31962798080,395.828,12720336024,10121800269,0,-5859703712,134136342,2155566278,6215400587,355696875,2905261200
66,3.46182,0,0,3432427845,3301572570,9938948,8535388,51548,3809922,2124329,169946320,136513088,89887616,79768108,55715552,32629002240,404.703,13022912123,10313958560,0,-5990558987,130855275,2240511835,6355031035,364472048,2937100522
67,3.30907,0,0,3471113491,3335246068,10351799,8916599,53291,3888789,2162403,172992240,137693184,91913728,83079591,56853888,33305978880,422.346,13339633797,10504672605,0,-6126426410,135867423,2330660890,6497922961,371496551,2963749517
68,3.33078,0,0,3504378236,3369257952,10778518,9311601,55039,3968924,2200450,176036000,138846272,93945472,86502011,57978176,33992949760,437.092,13666954159,10695190955,0,-6261546694,135120284,2422694673,6641047123,379500429,2989757523
69,3.36552,0,0,3533904097,3391937986,11224458,9725370,56754,4050053,2237353,178988240,139692096,96005568,90078050,59113344,34688532480,438.256,14011150584,10881931105,0,-6403512805,141966111,2518385772,6785993659,382480854,3009457132
70,4.05865,0,0,3596604172,3468218337,11559169,10026179,58647,4149217,2284535,182762800,142198208,98177216,92765139,60402944,35551836160,350.579,14432172280,11119546903,0,-6531898640,128385835,2587222811,6937967327,406068687,3062149650
71,5.90667,0,0,3806480965,3741890616,11759616,10202105,61429,4265450,2371143,189691440,154053568,99749760,94382585,61388160,36571084800,250.863,14677425192,11555280003,0,-6596488989,64590349,2639531039,7042475008,445986019,3295904597
72,4.77504,0,0,3969954506,3811303110,11964300,10368481,62773,4386386,2425654,194052320,157121792,102205696,96026745,63415520,37635307520,300.4,15226552119,11842311906,0,-6755140385,158651396,2715347836,7210531477,455391092,3355912018
73,4.78187,0,0,4033258736,3870637227,12190058,10555367,64126,4508081,2477154,198172320,159514048,104695232,97839518,64940832,38705633280,326.352,15810418135,12106816024,0,-6917761894,162621509,2793710653,7382188776,464426882,3406210345
74,4.94384,0,0,4103058851,3934502850,12441909,10766932,65422,4632072,2531806,202544480,162231680,107276480,99860726,66477504,39797422080,355.048,16387253290,12389348045,0,-7086317895,168556001,2875840811,7559183091,472865196,3461637654
75,4.15743,0,0,4138260111,3965633369,12823878,11112818,67344,4732223,2578458,206276640,164184832,109587328,102925968,67821024,40669081600,374.59,16820225065,12624278529,0,-7258944637,172626742,2994214028,7719353276,460408639,3505224730
76,4.10401,0,0,4169529934,4046579406,13147687,11403037,69312,4832181,2625447,210035760,166678464,111738944,105526256,69071264,41540311040,370.368,17249089460,12862747009,0,-7381895165,122950528,3081616703,7869380287,487485122,3559094284
77,4.21468,0,0,4248576562,4099807536,13479752,11698747,70977,4936619,2671964,213757120,168560896,114067520,108191093,70476256,42453647360,394.828,17723863614,13099312019,0,-7530664191,148769026,3186279727,8030664897,500000706,3599806830
78,4.25252,0,0,4302188075,4145136290,13826053,12007953,72582,5043629,2718584,217486720,170324032,116443968,110969462,71835744,43391784960,405.786,18221449975,13337482719,0,-7687715976,157051785,3293549866,8194834389,507118413,3638017877
79,4.31994,0,0,4348751825,4192314181,14191275,12335351,74205,5152164,2765822,221265760,172064320,118867264,113899329,73212384,44339476480,422.536,18724731319,13578277360,0,-7844153620,156437644,3402500436,8361828743,517675123,3674639058
80,4.26341,0,0,4392966658,4230422185,14572495,12678168,75695,5261707,2811976,224958080,173489472,121327168,116956475,74597888,45297090560,432.626,19244089151,13815881131,0,-8006698093,162544473,3513835972,8531139471,524441378,3705980807
81,4.30547,0,0,4432753044,4268266443,14973441,13040224,77259,5372102,2858319,228665520,174855296,123817984,120171815,75988576,46262865920,447.825,19768756888,14054657895,0,-8171184694,164486601,3626475965,8703208713,532024019,3736242424
82,4.4029,0,0,4474179055,4309355067,15389278,13416271,78851,5484739,2905801,232464080,176258048,126366720,123506423,77402784,47246745600,459.704,20302409172,14298972679,0,-8336008682,164823988,3738935223,8878794885,542786203,3766568864
83,4.73962,0,0,4506839841,4339065595,15821104,13808277,80352,5600065,2950934,236074720,177208000,128916928,126968496,78803424,48257771520,468.682,20879357690,14535565307,0,-8503782928,167774246,3854115159,9054768385,550985457,3788080138
84,4.91322,0,0,4557805865,4620586142,15922420,13900645,82870,5731739,3017224,241377920,188194048,129491200,127791558,79152640,49277399040,131.551,21424473736,14791336511,0,-8441002651,18446744073646771339,3890092290,9099015813,658013162,3962572980
85,4.35344,0,0,4780625041,4648421831,16059237,13995601,83283,5863315,3067312,245384960,189764544,132170432,128888143,81638976,50296299520,242.673,22093692051,14980979777,0,-8573205861,132203210,4029011108,9237565440,664359579,3984062252
86,4.33379,0,0,4807798199,4667891672,16235751,14127849,83710,5994894,3117225,249378000,190809920,135003520,130302374,83253664,51315251200,309.087,22764291149,15169955991,0,-8713112388,139906527,4171102871,9382541989,669429601,3998462071
87,4.33953,0,0,4827083805,4683864058,16451781,14298678,84163,6126492,3167083,253366640,191653696,137896384,132032879,84810016,52334315520,352.506,23435555841,15358563486,0,-8856332135,143219747,4315623397,9529975842,673643707,4010220351
88,4.39808,0,0,4843137363,4697899964,16706594,14507721,84673,6258093,3216960,257356800,192390016,140825728,134073933,86368224,53353451520,398.111,24106663173,15547318849,0,-9001569534,145237399,4462917194,9678395047,676825513,4021074451
89,4.35965,0,0,4856979019,4713907876,16996114,14752020,85272,6389710,3266777,261342160,193209664,143720000,136393080,87889760,54372659200,411.058,24778360993,15735749654,0,-9144640677,143071143,4610605606,9825612008,680971331,4032936545
90,4.33701,0,0,4872918751,4727283351,17324806,15034894,85928,6521331,3316599,265327920,193908672,146652416,139025880,89429984,55391877120,442.975,25449984091,15924333601,0,-9290276077,145635400,4762056339,9974443328,684167251,4043116100
91,4.35601,0,0,4886084960,4740950572,17693624,15357414,86635,6652951,3366420,269313600,194518400,149615488,141979959,90971488,56411115520,462.948,26121690041,16113064442,0,-9435410465,145134388,4917049274,10124499623,689089158,4051861414
92,4.59113,0,0,4915742454,4779620053,18062516,15683026,88097,6789356,3420253,273620240,196483456,152385472,144938397,92462400,57475020800,449.836,26804936345,16318931536,0,-9571532866,136122401,5068591194,10268298680,696765814,4082854239
93,4.48003,0,0,4940132584,4793669472,18468084,16042210,88993,6925770,3470576,277646080,197174144,155354048,148187421,94152032,58538926080,493.432,27517714826,16509545804,0,-9717995978,146463112,5225850022,10418739162,700743184,4092926288
94,4.50362,0,0,4954422038,4805664289,18910402,16437645,89976,7062177,3520920,281673600,197769856,158354624,151730872,95734688,59602882560,507.259,28230128104,16700336440,0,-9866753727,148757749,5385455806,10570646939,703893212,4101771077
95,4.47184,0,0,4966305531,4819039233,19387825,16868198,91016,7198603,3571264,285701120,198369984,161354368,155555456,97299680,60666931200,526.193,28942691473,16891180469,0,-10014020025,147266298,5546123831,10722513013,708492988,4110546245
96,4.46963,0,0,4979583903,4833369708,19891038,17325592,92100,7335032,3621567,289725360,199169728,164286848,159586572,98831072,61731010560,535.391,29655570857,17081835775,0,-10160234220,146214195,5709877675,10871808064,711573844,4121795864
97,4.46381,0,0,4993683470,4844218649,20440369,17827716,93232,7471465,3671829,293746320,199697152,167308096,163986872,100400896,62795141120,558.014,30368823402,17272400028,0,-10309699041,149464821,5875326434,11024370524,714671483,4129547166
98,4.54305,0,0,5004542076,4854449271,21027177,18367125,94384,7607907,3722086,297766880,200173760,170341632,168687096,101973536,63859333120,584.464,31082245489,17462846514,0,-10459791846,150092805,6043319342,11177490951,717699105,4136750166
99,4.48519,0,0,5014904206,4868435726,21641461,18934473,95646,7744382,3772484,301798720,200773184,173345600,173607678,103534656,64923545600,601.045,31794960773,17653888775,0,-10606260326,146468480,6212224722,11329463058,723202732,4145232994
100,4.6733,0,0,5043362083,4907560014,22237293,19486231,97556,7881525,3826224,306097920,202569280,176166592,178383868,105027584,65993615360,577.639,32485009757,17858983194,0,-10742062395,135802069,6377800905,11475633168,733570773,4173989241
101,4.53529,0,0,5069034666,4919877967,22858356,20061155,98912,8018709,3876836,310146880,203369152,179119488,183359152,106685696,67063726080,597.818,33201610019,18051019000,0,-10891219094,149156699,6549864623,11626249921,735030827,4184847140
102,4.68222,0,0,5081408696,4931964805,23521717,20677422,100385,8155889,3927427,314194160,203974080,182133504,188673405,108267168,68133898240,641.237,33918297237,18242973213,0,-11040662985,149443891,6723192783,11778902404,738239419,4193725386
103,4.57565,0,0,5093288372,4943282388,24223362,21331492,101870,8293084,3977998,318239840,204476544,185178496,194293990,109854656,69204080640,640.488,34635391079,18434738204,0,-11190668969,150005984,6898538174,11932544917,741875948,4201406440
104,4.5153,0,0,5104446879,4954370214,24951900,22012821,103434,8430283,4028520,322281600,205034816,188199872,200130106,111424960,70274334720,664.432,35352779667,18626439205,0,-11340745634,150076665,7075070069,12085497826,744752192,4209618022
105,4.533,0,0,5115090799,4964110965,25720460,22733704,105007,8567471,4078922,326313760,205481664,191251200,206286451,113003776,71344599040,688.432,36071157273,18817605334,0,-11491725468,150979834,7253932311,12239524887,747799419,4216311546
106,4.51089,0,0,5125163007,4974892663,26521015,23486994,106605,8704660,4129407,330352560,206048512,194276288,212698873,114564064,72414904320,716.097,36788895568,19009120277,0,-11641995812,150270344,7434039850,12392747455,750751643,4224141020
107,4.49277,0,0,5135713778,4983780069,27362023,24280053,108165,8841866,4179847,334387760,206456960,197345088,219434737,116149152,73485219840,722.865,37507145273,19200364977,0,-11793929521,151933709,7616758168,12547447474,753517953,4230262116
108,4.49686,0,0,5144354866,4995354740,28242565,25112390,109833,8979067,4230278,338422240,206821568,200430208,226487405,117737440,74555535360,751.283,38225422390,19391828583,0,-11942929647,149000126,7802545783,12702838417,759908770,4235445970
109,4.7731,0,0,5173549046,5033002733,29073560,25898218,112431,9118659,4285082,342806560,208610176,203321152,233148355,119272512,75647006720,711.442,38928269355,19602258672,0,-12083475960,140546313,7982090560,12852143379,768667419,4264335314
110,4.55322,0,0,5195925797,5045134179,29934612,26711466,114246,9258267,4336213,346897040,209178880,206380736,240045838,120988832,76738508800,734.631,39662657605,19796449438,0,-12234267578,150791618,8166501073,13006670094,772402516,4272731663
111,4.59972,0,0,5207526660,5055533881,30833125,27561816,116213,9397878,4387209,350976720,209655488,209463296,247243777,122596480,77830041600,768.393,40398102151,19990145211,0,-12386260357,151992779,8354727598,13161930885,775670528,4279863353
112,4.59353,0,0,5218151610,5065029745,31765046,28445202,117987,9537501,4438231,355058480,210072384,212569536,254708007,124206592,78921697280,781.344,41133269846,20184015467,0,-12539382222,153121865,8542667244,13318200409,778818187,4286211558
113,4.58968,0,0,5227335394,5074830137,32732732,29364492,119906,9677136,4489194,359135520,210496128,215667072,262459090,125804800,80013383680,801.948,41869160282,20377505782,0,-12691887479,152505257,8734899048,13474146970,782259491,4292570646
114,4.6294,0,0,5237125975,5085164021,33723792,30307462,121886,9816774,4540152,363212160,210977216,218744832,270397462,127392704,81105100800,825.034,42605097804,20570989542,0,-12843849433,151961954,8927231386,13629306402,785456969,4299707052
115,4.7244,0,0,5247896021,5104991161,34624581,31163246,124437,9956428,4591239,367299120,212054784,221625216,277616521,128917184,82196869120,766.411,43340210022,20764913644,0,-12986754293,142904860,9107367266,13775821757,789067464,4315923697
116,4.68774,0,0,5266947165,5118168113,35677755,32168291,126352,10096075,4642169,371373520,212593024,224705664,286051488,130504864,83288647680,815.884,44076457367,20958488855,0,-13135533345,148779052,9301524080,13930865345,795332000,4322836113
117,5.26463,0,0,5334070304,5179442491,36678682,33119753,130537,10239271,4707398,376591840,215524416,227871680,294079829,132224256,84415201280,831.397,44723393911,21222203720,0,-13290161158,154627813,9490742708,14097402352,807241194,4372201297
118,4.72612,0,0,5345127525,5192573661,37699504,34092338,132858,10382472,4759302,380744160,216139264,230958912,302258010,133969440,85541754880,812.1,45486830220,21419635977,0,-13442715022,152553864,9683628309,14253587243,810872221,4381701440
119,4.72986,0,0,5357524096,5203531761,38753833,35097876,135080,10525662,4811009,384880720,216612992,234081664,310703752,135605760,86668349440,855.859,46251531498,21616578824,0,-13596707357,153992335,9879180457,14411158492,814451135,4389080626
120,4.69025,0,0,5368366638,5213493265,39846353,36141325,137140,10668864,4862690,389015200,217042688,237222272,319454212,137231648,87795005440,862.66,47016793042,21813138403,0,-13751580730,154873373,10075832506,14569255959,817675229,4395818036
121,4.74096,0,0,5378146416,5224898474,40964366,37210604,139238,10812072,4914367,393149360,217543488,240341248,328408806,138844992,88921702400,886.548,47782205385,22009769869,0,-13904828672,153247942,10274039066,14726502970,821674298,4403224176
122,4.6841,0,0,5389297501,5234469533,42111057,38308475,141476,10955274,4965966,397277280,218006592,243465792,337593524,140459264,90048419840,903.813,48548315831,22205977836,0,-14059656640,154827968,10474039949,14884009525,824352885,4410116648
123,4.68595,0,0,5398671656,5244255748,43306346,39454725,143786,11098477,5017529,401402320,218427840,246604352,347167386,142074304,91175147520,923.82,49314786628,22402032596,0,-14214072548,154415908,10677849418,15041893797,827821249,4416434499
124,4.69891,0,0,5409191523,5259034935,44527835,40626972,146054,11241713,5069377,405550160,218857344,249756096,356950622,143701536,92301885440,950.286,50079232278,22599389091,0,-14364229136,150156588,10882072614,15200323429,836094293,4422940642
125,5.2055,0,0,5466796616,5309932880,45701242,41750983,150293,11386306,5131998,410559840,221322176,252918080,366359057,145393216,93438648320,928.626,50765498481,22842124087,0,-14521092872,156863736,11083311261,15365342584,844249712,4465683168
126,4.76826,0,0,5476240205,5322668559,46905720,42906786,152624,11530889,5184203,414736240,221936256,256033280,376006536,147118144,94575452160,929.815,51537518445,23040600638,0,-14674664518,153571646,11287007364,15522449818,847785300,4474883259
127,4.73368,0,0,5489487654,5332144492,48153783,44105036,154902,11675476,5236514,418921120,222345728,259221312,386002422,148781152,95712307200,966.794,52308456502,23239698526,0,-14832007680,157343162,11493877724,15682880701,850873021,4481271471
128,4.75847,0,0,5498964185,5344259970,49400809,45302969,157385,11820075,5288837,423106960,222896896,262363392,395991045,150414880,96849213440,974.487,53079528920,23438712655,0,-14986711895,154704215,11698828550,15841192629,854480734,4489779236
129,4.7332,0,0,5510403750,5355864547,50699414,46552479,160008,11964694,5341013,427281040,223426688,265505536,406393000,152037088,97986150400,991.524,53851927722,23637107033,0,-15141251098,154539203,11909080748,15999644258,858393160,4497471387
130,4.79185,0,0,5522058516,5364903296,52044118,47847478,162363,12109300,5393176,431454080,223832512,268686656,417162407,153678752,99123128320,1021.83,54624226163,23835592543,0,-15298406318,157155220,12121457974,16159642691,861236373,4503666923
131,4.75623,0,0,5531016154,5373436122,53424166,49177465,164820,12253926,5445320,435625600,224161920,271890624,428215076,155329920,100260136960,1040.13,55396698321,24034016167,0,-15455986350,157580032,12337385664,16320537009,864550659,4508885463
132,4.79972,0,0,5539533280,5388028886,54814695,50518621,167475,12398548,5497542,439803360,224641792,275050496,439352583,156955200,101397155840,1109.42,56168756171,24232880039,0,-15607490744,151504394,12550282121,16479674338,872183594,4515845292
133,5.42799,0,0,5602765719,5442475387,56170193,51823249,172166,12545097,5562081,444966480,227187136,278306688,450220014,158697120,102548981760,1055.29,56852754072,24485971225,0,-15767781076,160290332,12763134490,16650392882,882611806,4559863581
134,4.82169,0,0,5610839766,5454196479,57528606,53132061,174900,12691644,5614873,449189840,227719168,281481152,461100988,160470496,103700858880,1014.66,57635193960,24687044078,0,-15924424363,156643287,12976308317,16810480864,886056501,4568139978
135,4.83911,0,0,5622447781,5466057362,58925878,54479497,177645,12838179,5667656,453412480,228218304,284670784,472292889,162133504,104852695040,1063.85,58417635868,24888187028,0,-16080814782,156390419,13192482798,16971159095,890344313,4575713049
136,4.79893,0,0,5633977425,5475167045,60361984,55865295,180203,12984719,5720356,457628480,228614208,287890496,483794519,163797536,106004582400,1066.46,59200916292,25088873901,0,-16239625162,158810380,13410595996,17132865825,893240663,4581926382
137,4.84729,0,0,5643632041,5484240711,61840620,57293414,182770,13131282,5773211,461856880,228994688,291123712,495636442,165463488,107156531200,1106.16,59983033831,25290240166,0,-16399016492,159391330,13632402767,17295383998,896367506,4587873205
138,4.8728,0,0,5651740617,5493415600,63355211,58757667,185422,13277837,5825817,466065360,229362048,294345344,507766430,167119648,108308510720,1132.34,60767196932,25490556679,0,-16557341509,158325017,13855668720,17457222514,899881005,4593534595
139,4.7662,0,0,5660799839,5503080436,64896848,60249239,188314,13424392,5878396,470271680,229774016,297549504,520113986,168763872,109460510720,1155.69,61551713111,25690656261,0,-16715060912,157719403,14080890320,17618409339,903348427,4599732009
140,4.81963,0,0,5669984575,5511583571,66466008,61768144,190870,13570948,5930869,474469520,230119680,300765824,532680046,170417984,110612531200,1188.11,62337222590,25890263123,0,-16873461916,158401004,14307179253,17779903253,906441337,4605142234
141,5.49423,0,0,5678505985,5525750733,68070048,63322118,193664,13717508,5983398,478671840,230532736,303970112,545526336,172058912,111764561920,1193.24,63122162056,26090431963,0,-17026217168,152755252,14534136601,17940897269,914680101,4611070632
142,5.28665,0,0,5736615727,5578149986,69618232,64819580,198544,13865135,6046844,483747520,232910784,307216704,557936192,173787904,112924160000,1166.34,63824006984,26337320121,0,-17184682909,158465741,14759508508,18110362380,925679471,4652470515
143,4.82562,0,0,5748430596,5591114564,71176419,66327781,201833,14012779,6100271,488021680,233502976,310416000,570418133,175567936,114083840000,1168.01,64609648187,26541078308,0,-17341998941,157316032,14987472078,18271813242,929814301,4661300263
144,4.83851,0,0,5760782071,5602529576,72774073,67875094,204791,14160436,6153532,492282560,234003840,313637888,583214155,177241632,115243591680,1187.38,65396846560,26743964108,0,-17500251436,158252495,15217813494,18434014301,933762865,4668766711
145,4.89697,0,0,5771496956,5613072268,74407385,69457883,207775,14308094,6206651,496532080,234429952,316871616,596295571,178912800,116403363840,1211.69,66185330031,26946285417,0,-17658676124,158424688,15450618530,18596519563,937843439,4675228829
146,4.89457,0,0,5782159979,5622624822,76077635,71077524,210662,14455751,6259771,500781680,234847168,320110656,609672006,180578176,117563156480,1239.11,66973743410,27148576967,0,-17818211281,159535157,15684393906,18759123044,940911763,4681713059
147,4.81705,0,0,5791864026,5632411226,77772778,72722082,213499,14603419,6312927,505034160,235278336,323348224,623247335,182241408,118722979840,1280.49,67761781103,27351123430,0,-17977664081,159452800,15919308202,18921859883,944195802,4688215424
148,4.85544,0,0,5801383133,5642645528,79481104,74379921,216729,14751091,6366022,509281760,235696000,326579648,636930085,183901632,119882833920,1262.31,68550431975,27553354731,0,-18136401686,158737605,16154850472,19084289487,947887801,4694757727
149,4.8703,0,0,5811375288,5653521377,81228014,76076440,219829,14898780,6419081,513526480,236142848,329804800,650920849,185559136,121042749440,1290.67,69339666335,27755306131,0,-18294255597,157853911,16392398836,19246441699,952186102,4701335275
150,4.84732,0,0,5821553732,5671278591,82959983,77759109,223079,15046488,6472071,517765680,236779008,332960128,664792851,187188416,122202664960,1266.78,70129711221,27957144410,0,-18444530738,150275141,16626910615,19405406376,960875638,4710402953
151,5.58346,0,0,5892675987,5735449343,84653649,79401103,228500,15199872,6539943,523195440,239810752,336267840,678369284,188968032,123417753600,1254.83,70849307251,28231239624,0,-18601757382,157226644,16862771033,19577101116,975343734,4760105609
152,4.99239,0,0,5909071594,5753445050,86345077,81042122,231913,15353317,6594470,527557600,240535040,339494144,691917773,190790528,124632872960,1221.78,71683264348,28438779636,0,-18757383926,155626544,17101677660,19739841783,982457857,4770987193
153,5.08075,0,0,5924621393,5763253684,88041447,82688305,235246,15506695,6648297,531863760,241156288,342706240,705505398,192472544,125848012800,1232.74,72522378947,28643628534,0,-18918751635,161367709,17342624026,19901331829,982580194,4780673490
154,5.06278,0,0,5933808985,5773398700,89822646,84418326,238005,15660073,6701986,536158880,241592128,345981824,719768785,194166752,127063173120,1269.46,73362775295,28847837205,0,-19079161920,160410285,17586967894,20065612689,986450769,4786947931
155,5.00295,0,0,5944614919,5784498184,91611032,86155785,241157,15813466,6755848,540467840,242082112,349241408,734091633,195851328,128278364160,1287.03,74201800197,29052787124,0,-19239278655,160116735,17831236477,20229406916,990128261,4794369923
156,5.03149,0,0,5954915405,5793322578,93457700,87951241,244260,15966845,6809497,544759760,242474944,352519040,748880492,197537856,129493585920,1335.13,75042496056,29256895804,0,-19400871482,161592827,18081577364,20393757403,992885921,4800436657
157,4.99085,0,0,5963590481,5802645288,95324249,89766638,247359,16120231,6863110,549048800,242869568,355792896,763828379,199221952,130708838400,1318.47,75883535191,29460841246,0,-19561816675,160945193,18329709837,20557992372,996175697,4806469591
158,4.9625,0,0,5972848409,5818980245,97204721,91596301,250520,16273635,6916796,553343680,243344000,359044800,778887960,200898304,131924121600,1318.97,76724170351,29665286165,0,-19715684839,153868164,18578349936,20721537076,1005852237,4813128008
159,5.72516,0,0,6043985960,5885624274,99010243,93349669,256167,16432672,6986179,558894320,246580224,362383680,793360347,202690528,133193093120,1281.78,77482867096,29950555225,0,-19874046525,158361686,18824689297,20894987104,1020940579,4864683695
160,5.15391,0,0,6058870585,5898434614,100839360,95127554,259354,16591717,7040759,563260720,247150592,365662720,808009210,204532000,134462115840,1313.87,78370643291,30158555439,0,-20034482496,160435971,19075400294,21059700013,1025217517,4873217097
161,5.20898,0,0,6070934458,5908378876,102711474,96947968,262392,16750765,7095152,567612160,247595136,368971584,823001304,206254016,135731169280,1344.02,79260037617,30365714709,0,-20197038078,162555582,19329052370,21225468821,1028430743,4879948133
162,5.10493,0,0,6081588596,5921368391,104581092,98766443,265667,16909823,7149735,571978800,248178048,372244864,837974623,207947296,137000284160,1360.25,80147910498,30573746988,0,-20357258283,160220205,19581159306,21389755587,1032497304,4888871087
163,5.16459,0,0,6093888268,5931981274,106503596,100637447,268852,17068894,7204162,576332960,248678400,375540992,853370580,209646592,138269429760,1363.75,81037231373,30781051836,0,-20519165277,161906994,19836687897,21554876832,1035711555,4896269719
164,5.09812,0,0,6104588592,5940700836,108480776,102562538,271778,17227987,7258637,580690960,249060928,378874816,869202650,211360416,139538616320,1390.44,81926245941,30988616510,0,-20683053033,163887756,20094950016,21721447606,1038394573,4902306263
165,5.27813,0,0,6113913990,5948794811,110498736,104527926,274632,17387065,7313186,585054880,249371008,382239488,885360600,213087168,140807874560,1451.58,82814372370,31196535167,0,-20848172212,165119179,20356438811,21889588850,1041416638,4907378173
166,5.23697,0,0,6121395586,5959840941,112539784,106517068,277737,17546148,7367606,589408480,249787648,385561600,901704509,214787968,142077173760,1426.86,83703761390,31403844572,0,-21009726857,161554645,20617600868,22055966275,1046239418,4913601523
167,5.10444,0,0,6131946765,5975568463,114598111,108523819,280938,17705238,7421960,593756800,250247488,388862656,918187130,216479808,143346472960,1442.19,84593664143,31611135195,0,-21166105159,156378302,20880924377,22221531124,1055425965,4920142498
168,5.98007,0,0,6204842251,6051871959,116555609,110427883,286804,17871608,7493103,599448240,253569984,392283392,933876420,218324480,144686622720,1380.89,85405806969,31909868341,0,-21319075451,152970292,21136894760,22398436485,1079361034,4972510925
169,5.55742,0,0,6227579560,6067332095,118522921,112343446,290446,18038000,7548575,603886000,254214720,395595392,949633126,220189824,146026885120,1406.97,86358180628,32122049481,0,-21479322916,160247465,21406337838,22564634783,1085311867,4982020228
170,5.33401,0,0,6242553277,6078509105,120529270,114297347,293741,18204393,7603892,608311360,254692160,398952128,965700393,221940256,147367188480,1401.08,87311875090,32333437197,0,-21643367088,164044172,21680959434,22732563591,1089196503,4989312602
171,5.33031,0,0,6253162469,6089345649,122563491,116279134,297174,18370801,7659113,612729040,255154752,402307968,981991326,223672704,148707532800,1434.56,88266630446,32544372797,0,-21807183908,163816820,21954276667,22900291945,1093108037,4996237612
172,5.29609,0,0,6264067691,6098847170,124626512,118289498,300277,18537208,7714323,617145840,255575296,405678080,998511009,225410464,150047907840,1454,89221397149,32755259092,0,-21972404429,165220521,22229170577,23068628964,1096224535,5002622635
173,5.30424,0,0,6272823544,6107848216,126747677,120357852,303292,18703598,7769365,621549200,255937344,409058048,1015495404,227147456,151388282880,1493.24,90177485672,32965569235,0,-22137379757,164975328,22509320755,23237088461,1099708704,5008139512
174,5.36932,0,0,6282760126,6118637802,128892738,122450331,306885,18870016,7824654,625972320,256383424,412423616,1032673857,228869824,152728678400,1488.64,91131762321,33176776196,0,-22301502081,164122324,22787625971,23405374996,1103872915,5014764887
175,5.42255,0,0,6293002079,6132080942,131046660,124552167,310377,19036431,7879855,630388400,256907776,415757248,1049922693,230582176,154069094400,1508.87,92086700881,33387889359,0,-22462423218,160921137,23065857294,23572229168,1109805950,5022274992
176,5.89761,0,0,6353801577,6189934429,133144954,126596456,316431,19204970,7947283,635782640,259414592,419214144,1066739315,232423872,155427072000,1491.26,92956802938,33654044267,0,-22626290366,163867148,23342846264,23751703506,1125413140,5064521289
177,5.4639,0,0,6367022271,6202490160,135266450,128665112,319695,19373528,8003233,640258640,259951744,422595904,1083727603,234297056,156785080320,1523.1,93923806163,33867961520,0,-22790822477,164532111,23626075407,23920710728,1129888251,5072601909
178,5.42026,0,0,6379095352,6215227063,137412974,130758960,323378,19542094,8059071,644725680,260493248,425967296,1100918210,236044320,158143160320,1486.4,94891783371,34081459120,0,-22954690766,163868289,23910022643,24089315322,1134624556,5080602507
179,5.39153,0,0,6391565604,6225903195,139597935,132890845,326724,19710653,8114829,649186320,260933696,429364288,1118414628,237795808,159501312000,1532.35,95860371459,34294684171,0,-23120353175,165662409,24194075559,24258932107,1138578932,5087324263
180,5.37936,0,0,6402511892,6237412478,141810579,135050682,330303,19879237,8170643,653651440,261435392,432744064,1136133675,239536544,160859514880,1559.52,96828354494,34508295319,0,-23285452589,165099414,24480607320,24428127708,1142675119,5094737359
181,5.51855,0,0,6413590127,6247325360,144069842,137256691,333643,20047806,8226364,658109120,261844480,436152320,1154224479,241288960,162217758720,1570.47,97797265755,34721450249,0,-23451717356,166264767,24770561977,24598148697,1146431341,5100894019
182,5.57192,0,0,6423455884,6256293026,146370287,139503687,336807,20216370,8282043,662563440,262205440,439573056,1172643859,243044480,163576033280,1576.17,98766507067,34934352973,0,-23618880214,167162858,25064186157,24768631303,1149751089,5106541937
183,5.50605,0,0,6431838559,6265433149,148691741,141771692,339987,20384950,8337612,667008960,262538240,442993792,1191231391,244797120,164934328320,1640.54,99736889847,35146719700,0,-23785285624,166405410,25356867549,24938991446,1153705822,5111727327
184,5.47554,0,0,6441674614,6281197344,151000889,144028276,344123,20553560,8393455,671476400,263102528,446358016,1209725255,246526240,166292654080,1599.25,100705542522,35360151320,0,-23945762894,160477270,25647695990,25107153850,1161390956,5119806388
185,5.98271,0,0,6507069066,6348033133,153209319,146183971,350459,20723675,8462678,677014240,266212800,449733952,1227424367,248332000,167663493120,1529.6,101576279562,35634381598,0,-24104798827,159035933,25930434281,25283017371,1178218544,5169814589
186,5.42494,0,0,6525495163,6361775614,155468987,148390776,353967,20893798,8519013,681521040,266802240,453117312,1245519251,250213888,169034352640,1552.43,102554193983,35849864667,0,-24268518376,163719549,26222126933,25452112723,1183594347,5178181267
187,5.41244,0,0,6539283825,6370616510,157771358,150639531,357220,21063940,8575207,686016560,267213888,456548864,1263954484,251998912,170405345280,1585.29,103532858997,36064684082,0,-24437185691,168667315,26519411463,25623170282,1185984591,5184631919
188,5.50828,0,0,6548639027,6383475122,160079330,152894202,361138,21234087,8631553,690524240,267710784,459960128,1282437850,253760800,171776358400,1592.24,104510515244,36280018438,0,-24602349596,165163905,26812453286,25793557674,1191208078,5192267044
189,5.55574,0,0,6561862195,6397964976,162418790,155180554,364745,21404307,8688071,695045680,268312320,463359168,1301171565,255512544,173147412480,1615.77,105487430440,36495770249,0,-24766246815,163897219,27109461371,25963312651,1197065836,5200899140
190,5.65208,0,0,6575297761,6405832430,164822751,157530808,368368,21574459,8744241,699539280,268704256,466796544,1320421368,257277600,174518497280,1633.16,106466504886,36710447818,0,-24935712146,169465331,27412314972,26134477880,1198765734,5207066696
191,5.45848,0,0,6583667164,6414188460,167260515,159914573,371690,21744621,8800529,704042320,269077760,470252480,1339940090,259048512,175889623040,1665.61,107444455779,36925787951,0,-25105190850,169478704,27715507163,26306502443,1201311593,5212876867
192,5.46555,0,0,6591996999,6426561333,169714396,162314748,375276,21914791,8856854,708548320,269514048,473689728,1359589068,260812064,177260779520,1671.07,108422625199,37140966472,0,-25270626516,165435666,28015826326,26477882285,1207255769,5219305564
193,5.49703,0,0,6603771938,6440138907,172193972,164741015,379247,22084968,8913055,713044400,269990720,477101568,1379445531,262569920,178631956480,1685.07,109401626860,37355931166,0,-25434259547,163633031,28320804569,26648290455,1214030908,5226107999
194,5.87693,0,0,6662411811,6504769350,174432687,166927080,386189,22255865,8980604,718448320,272753408,480471872,1397389953,264367424,180008785920,1533.6,110291688913,37620425649,0,-25591902008,157642461,28604901214,26823680550,1231778542,5272990808
195,5.49401,0,0,6682749173,6517571088,176794131,169235571,389830,22426581,9037002,722960160,273357632,483860992,1416299702,266257536,181384161280,1613.52,111273417287,37836092812,0,-25757080093,165178085,28904664183,26992876701,1235796608,5281774480
196,5.49158,0,0,6696398613,6529574558,179194078,171581941,393472,22597302,9093587,727486960,273854016,487289984,1435517488,268044096,182759557120,1643.98,112253519208,38052559206,0,-25923904148,166824055,29205526626,27164046382,1240142234,5289432324
197,5.55048,0,0,6712187485,6555115954,181576442,173911240,397574,22768161,9151442,732115360,274695232,490686592,1454596870,269802432,184135045120,1657.2,113224540190,38274413297,0,-26080975679,157071531,29505323520,27333810538,1252834859,5302281095
198,5.4838,0,0,6732796051,6556450090,184063827,176344611,400770,22938889,9207764,736621120,275069568,494143552,1474511930,271580192,185510553600,1715.36,114206931343,38489850527,0,-26257321640,176345961,29819268388,27505548796,1248227156,5308222934
199,5.48289,0,0,6734404826,6565852651,186581040,178807979,404295,23109615,9264109,741128720,275472960,497589760,1494667259,273344480,186886092800,1723.49,115189083926,38705282408,0,-26425873815,168552175,30127784276,27677215717,1251341902,5314510749
200,5.66536,0,0,6743557713,6576181489,189093705,181266797,407908,23280342,9320425,745634000,275872320,501035968,1514786644,275117056,188261672960,1729.34,116171560454,38920680978,0,-26593250039,167376224,30433958822,27848818796,1255568757,5320612732
201,5.51415,0,0,6753529925,6590292633,191663422,183782874,411759,23451071,9376713,750137040,276321216,504468928,1535363635,276879648,189637263360,1720.27,117154422073,39136061323,0,-26756487331,163237292,30744768703,28019751019,1263263688,5327028945
202,6.03752,0,0,6815666572,6652538606,194140629,186205148,418251,23624353,9445834,755666720,278967488,507985344,1555213743,278757568,191035095040,1703.04,118050625680,39412315457,0,-26919615297,163127966,31049120511,28201193715,1281578418,5370960188
203,5.55284,0,0,6832177889,6665768615,196608611,188620042,421892,23797633,9502769,760221520,279629504,511382976,1574975804,280642688,192432947200,1700,119050915728,39630238286,0,-27086024571,166409274,31358888501,28371344588,1285320017,5380448598
204,5.56657,0,0,6845953469,6676406744,199136352,191093631,425694,23970923,9559830,764786400,280119232,514848960,1595216734,282441536,193830860800,1721.97,120049957325,39848925435,0,-27255571296,169546725,31672840254,28544166644,1288595348,5387811396
205,5.54052,0,0,6855822338,6688203166,201685884,193589059,429598,24144207,9616711,769336880,280570368,518311680,1615632510,284227456,195228825600,1766.47,121050692914,40066739052,0,-27423190468,167619172,31987729330,28716621576,1293431108,5394772058
206,5.69625,0,0,6867978918,6698416612,204278920,196127645,433496,24317512,9673673,773893840,280973632,521796608,1636396288,286021056,196626841600,1754.99,122050843983,40284828231,0,-27592752774,169562306,32305025908,28890065417,1297312643,5401103969
207,5.57208,0,0,6877859735,6706936912,206909872,198703952,436994,24490811,9730548,778443840,281326336,525294016,1657461394,287816672,198024898560,1784.88,123051573658,40502712393,0,-27763675597,170922823,32624054593,29064037059,1300361462,5406575450
208,5.54852,0,0,6886476924,6720349747,209519184,201259625,440841,24664123,9787441,782995280,281862656,528726976,1678355125,289586240,199422996480,1771.61,124052221295,40720622664,0,-27929802774,166127177,32939409603,29235467550,1305664776,5414684971
209,5.64912,0,0,6899771230,6735311131,212202296,203888542,444600,24837474,9844409,787552720,282348672,532195456,1699838816,291364736,200821145600,1799.97,125052654675,40938916921,0,-28094262873,164460099,33261083893,29408200383,1313937510,5421373621
