Backup ID,Backup Online Processtime(s),Online Load Times,Online Delta num,Online Size,Offline Size,Offline Delta times,Offline Decompress times,Offline Delete times,Logic chunk num,Unique chunk num,FpIndex size,SfIndex size,Localmap size,Coldmap size,Deltamap size,total logical size,offline_time,online_dedupReduce,online_lz4Reduce,online_deltaReduce,offlineDelta_diff,offlineDelta_sum,offlineReDelta_sum,offlineRelz4_sum,_sum_Delta_size,_sum_Lz4_size
0,24.2789,0,0,628342123,605883406,7352,0,124,598895,116850,9348000,20875072,484416,59436,319328,8588886016,53.3385,7577242754,383301139,0,-22458717,22458717,0,30484709,8025992,597857414
1,21.3579,0,0,637291605,633776355,11356,2319,214,1197560,122453,9796240,21623680,593088,91910,398112,17177772032,18.4656,16109115380,408906330,0,-25973967,3515250,5370437,37280337,11306370,622469985
2,21.058,0,0,667110374,660344413,17346,5597,329,1796008,129193,10335440,22395072,766976,140405,528768,25766658048,28.3819,24626229913,447343794,0,-32739928,6765961,13618651,48397365,15657437,644686976
3,21.1848,0,0,674705841,671767868,22934,9853,417,2394289,132218,10577440,22709760,855488,185525,578944,34355544064,24.1918,33181971849,466126446,0,-35677901,2937973,24688683,53728338,18050437,653717431
4,20.8248,0,0,699014782,695413546,29291,14591,527,2992254,137183,10974640,23350336,959424,236931,647424,42944430080,25.0634,41719690099,490047298,0,-39279137,3601236,37421327,60886951,21607814,673805732
5,21.1523,0,0,719735000,716002199,36414,20248,642,3590141,141681,11334480,23930560,1053760,294474,708992,51533316096,25.9836,50261947521,512354438,0,-43011938,3732801,53336955,66984107,23972169,692030030
6,20.9519,0,0,742630494,739057723,43874,26214,762,4187832,146604,11728320,24568576,1155712,354730,756768,60122202112,28.8454,58800648944,535910736,0,-46584709,3572771,70265186,73522025,26937316,712120407
7,21.2034,0,0,777951342,773056587,52726,32886,903,4785201,153531,12282480,25476608,1296064,426235,838720,68711088128,46.7448,67317831644,568720433,0,-51479464,4894755,89665353,83715261,32235797,740820790
8,20.8524,0,0,791113700,788495745,61126,40238,1025,5382415,156743,12539440,25891392,1363328,494029,882112,77299974144,32.28,75873466198,583914782,0,-54097419,2617955,113132758,88490234,34392815,754102930
9,21.2057,0,0,832459780,827634443,71557,48507,1189,5979346,164425,13154000,26947968,1502400,578289,969760,85888860160,43.9206,84385714437,616588524,0,-58922756,4825337,138546699,98241834,39319078,788315365
10,21.1058,0,0,858934386,853859578,83428,57991,1363,6576018,170688,13655040,27687232,1656512,674111,1064544,94477746176,50.7343,92907444263,652444771,0,-63997564,5074808,168249486,108785958,44788394,809071184
11,20.8578,0,0,868112781,865509689,94117,67737,1502,7172565,173447,13875760,28034880,1717056,760294,1103584,103066632192,38.1031,101467450779,667071068,0,-66600656,2603092,201092495,113427235,46826579,818683110
12,21.0716,0,0,902434064,900276312,105422,77896,1649,7768591,179273,14341840,28932736,1790400,851461,1148576,111655518208,45.9288,110000215514,686267974,0,-68758408,2157752,235400056,119110571,50352163,849924149
13,20.9929,0,0,937382310,932147864,119561,89645,1859,8364315,186287,14902960,29817920,1943808,965615,1247168,120244404224,48.1723,118516184752,722078754,0,-73992854,5234446,273876983,129940876,55948022,876199842
14,21.2266,0,0,963471383,958414540,134549,102433,2068,8959750,192236,15378880,30536320,2084736,1086532,1336096,128833290240,49.8164,127042266193,753559810,0,-79049697,5056843,316231663,140396947,61347250,897067290
15,21.0712,0,0,1004226546,998950603,150827,116481,2289,9555592,200085,16006800,31611840,2228160,1217845,1426176,137422176256,67.243,135552472326,786427687,0,-84325640,5275943,363264733,150798936,66473296,932477307
16,21.1531,0,0,1034549638,1029184260,167774,131263,2509,10151063,206500,16520000,32422912,2368128,1354513,1515328,146011062272,82.2342,144074847956,817339038,0,-89691018,5365378,413888427,161317935,71626917,957557343
17,21.0335,0,0,1057190415,1052833230,185304,146933,2720,10746509,211749,16939920,33070208,2488000,1495792,1588640,154599948288,66.7015,152609031672,844035183,0,-94048203,4357185,467964046,169691528,75643325,977189905
18,20.5666,0,0,1078401937,1075317776,200434,160697,2932,11341783,216232,17298560,33667520,2575424,1617884,1643872,163188834304,45.6294,161152293281,864090883,0,-97132364,3084161,521375707,176359057,79226693,996091083
19,20.0048,0,0,1121380148,1115115060,218632,176132,3199,11937069,224744,17979520,34767552,2753152,1764771,1751296,171777720320,51.652,169652341774,906866034,0,-103397452,6265088,578612777,189399969,86002517,1029112543
20,18.7128,0,0,1146051883,1141874497,239141,194898,3432,12532503,230313,18425040,35500864,2864768,1929976,1821728,180366606336,37.0967,178182838561,934318440,0,-107574838,4177386,644517527,197540325,89965487,1051909010
21,18.858,0,0,1178680237,1173589566,258541,212143,3697,13128330,236831,18946480,36334272,3003776,2086485,1905760,188955492352,41.1025,186703485023,965752254,0,-112665509,5090671,709473618,207664086,94998577,1078590989
22,18.3534,0,0,1208560114,1204151307,278245,230010,3947,13724614,242852,19428160,37136448,3121600,2245359,1980640,197544378368,38.9782,195230029193,993123552,0,-117074316,4408807,777815674,216729278,99654962,1104496345
23,19.0036,0,0,1232462649,1228682867,298551,248614,4194,14321201,248008,19840640,37796928,3231040,2409018,2047488,206133264384,41.6919,203765937336,1017790083,0,-120854098,3779782,849383343,224518752,103664654,1125018213
24,18.34,0,0,1257743672,1252861837,320042,268328,4453,14918079,253296,20263680,38468544,3345408,2582193,2119456,214722150400,42.7713,212299298695,1044253935,0,-125735933,4881835,924614959,233112651,107376718,1145485119
25,19.1016,0,0,1310461131,1304747463,343738,288643,4747,15514344,263864,21109120,39825600,3568960,2773207,2233152,223311036416,55.6503,220778045239,1096794113,0,-131449601,5713668,1001240851,250007543,118557942,1186189521
26,18.6414,0,0,1339526522,1335016990,367757,310510,5036,16110797,270198,21615840,40627328,3706816,2966772,2317600,231899922432,56.472,229300467030,1128479279,0,-135959133,4509532,1087616972,260548800,124589667,1210427323
27,18.8012,0,0,1367989455,1363541011,392959,333674,5312,16707645,276189,22095120,41384192,3837696,3169744,2396672,240488808448,51.6908,237826131997,1158727863,0,-140407577,4448444,1178452966,270115043,129707466,1233833545
28,18.8063,0,0,1407926766,1402144014,418097,356397,5624,17305024,284120,22729600,42427584,3996992,3372392,2435104,249077694464,54.8362,246332755486,1196604635,0,-146190329,5782752,1271742824,282139463,135949134,1266194880
29,18.7885,0,0,1445116781,1439659126,444270,380062,5925,17903139,291725,23338000,43404160,4157696,3583265,2535168,257666580480,57.6777,254842576130,1232697240,0,-151647984,5457655,1369662668,294153422,142505438,1297153688
